111111111111
100000100001
101100100101
100000000101
111111111111