11111111111111111
10C10000010000001
10010111110111101
10111000000100101
10000C00111110101
1001P011101C10101
100100011E00A0001
11111111111111111