11111111111111111
10000000010000001
10000111110111101
10101000000100101
11000000111110101
1000P011101C10101
100C00011E0000001
11111111111111111