11111111111111111
1001000001000C001
10010111110111101
101110000001P0101
10000000111110101
10010011101C10101
100100011E00A0001
11111111111111111