11111
10EP1
10001
10001
10111
100C1
11111