111111111111111
10C01C100000C01
100010000000001
100000111110001
1000011E0P10001
1C0001100000001
111111111111111