11111111110111111
10C00000000100C01
10000000000111101
10001100000000101
10001100111110101
100000011E0P10101
1C0000011000000C1
11111111111111111