111111111111111
10C010000000C01
100010000000001
100000111110001
10P0011E0010001
100001100000001
111111111111111