11111111111111111
100000000100000P1
10010111110111101
10101000000100101
11000100111110101
10000011100C10101
100C00011E0000001
11111111111111111