1111111111111111111111111111111111
1C100000000000EC000000000000000001
1010010100000000101001000000010101
1010010010101010001001000000010101
1P0000001CC10000000000000000000001
1111111111111111111111111111111111