111111111111111111111111111111111111
1000000100P0000C00000000000000000001
110000000E0C0000000000000000000000001
111111111111111111111111111111111111