1111111111111111111111111111111111
10000000000000010000010001000001C1
1000000000000001000001010100010101
100000000000000100CC01010100010101
1000000000000001000000010100010101
10000000000000010P0011110100010101
1000000000000001000010000100010101
1111E11111111111000010111100010101
1000000000000000000010100100010101
1000000000000000000010100100010101
1000000000000000000010000000010001
1111111111111111111111111111111111