1111111111111111111111111111111111
1000000000000001000001000000000001
1000000000000001000001011100010101
1000000000000001000001000100010101
10000000C0000001000000000100000001
1000000000000001000011111100000001
1000000000000001000010000000000001
1111E11111111111000010111110000001
100000000000000000001010C010000001
1000000000000000000010100010000001
1P00000000000000000010000010000001
1111111111111111111111111111111111